// Maze Grid: 15x15
// Name: Maze_15x15_D8_T15_J22+4
// 0=Wall, 1=Path
0 0 1 1 1 1 1 1 0 0 1 1 1 1 0
0 0 0 0 1 0 0 1 0 0 1 0 0 1 0
0 1 1 1 1 1 1 1 1 0 1 0 0 1 0
0 1 0 0 1 0 1 0 1 0 1 1 1 1 0
0 1 1 1 1 0 1 0 1 0 1 0 0 1 0
0 1 0 0 1 1 1 1 1 0 1 0 0 1 0
0 1 1 1 0 0 1 0 1 0 1 1 1 0 0
0 0 1 0 0 0 1 0 1 0 0 0 1 0 0
0 0 1 0 1 1 1 1 1 0 0 0 1 0 1
0 0 1 0 1 0 0 1 1 1 1 1 1 0 1
0 1 1 1 1 1 1 1 0 0 1 0 1 0 1
0 1 0 0 1 0 0 1 0 0 1 0 1 1 1
0 1 1 1 1 0 0 1 1 1 1 1 1 0 1
0 1 0 0 0 0 0 0 0 0 1 0 0 0 1
0 1 1 1 1 0 0 1 1 1 1 1 1 0 0
